维护者：Naki64191
版本号：1.0.1
更新时间：2025-09-08

词条

// 武装侦探社
Armed Detective Agency = 武装侦探社
Fukuzawa Yukichi = 福泽 谕吉
Edogawa Ranpo = 江户川 乱步
Kunikida Doppo = 国木田 独步
Nakajima Atsushi = 中岛 敦
Dazai Osamu = 太宰 治
Yosano Akiko = 与谢野 晶子
Tanizaki Junichiro = 谷崎 潤一郎
Tanizaki Naomi = 谷崎 直美
Miyazawa Kenji = 宫泽 贤治
Izumi Kyouka = 泉镜花
Tayama Katai = 田山 花袋
Haruno Kirako = 春野 绮罗子

// 港口黑手党
Port Mafia = 港口黑手党
Mori Ogai = 森 鸥外
Elise = 爱丽丝
Nakahara Chuuya = 中原 中也
（Chuya等同于Chuuya，可译作中也）
Akutagawa Ryunosuke = 芥川 龙之介
Higuchi Ichiyo = 樋口 一叶
Akutagawa Gin = 芥川 银
Hirotsu Ryuro = 广津 柳浪
Tachihara Michizou = 立原 道造
Ozaki Kouyou = 尾崎 红叶
Kajii Motojirou = 梶井 基次郎
Oda Sakunosuke = 织田 作之助
Randou = 兰堂
Paul Verlaine = 保尔·魏尔伦
Yumeno Kyusaku = 梦野 久作
Taisa = 大佐

// 旗会
Flats = 旗会
Piano Man = 钢琴家
Albatross = 阿呆鸟
Ice Man = 冷血
Doctor = 外科医生
Lipmann = 公关官

// 异能特务科
Sakaguchi Ango = 坂口 安吾
Taneda Santouka = 种田 山頭火
Tsujimura Mizuki = 辻村 深月
Murakoso Yachiyo = 村社 八千代
Aoki Takuichi = 青木 卓一

// 组合
The Guild = 组合
Francis Scott Key Fitzgerald = 弗朗西斯·司各特·基·菲茨杰拉德
Louisa May Alcott = 路易莎·梅·奥尔科特
Lucy Maud Montgomery = 露西·蒙哥马利
Margaret Mitchell = 玛格丽特·米切尔
Nathaniel.H = 纳撒尼尔·霍桑
John Steinbeck = 约翰·斯坦贝克
Howard Phillips Lovecraft = 霍华德·菲利普斯·洛夫克拉夫特
Mark Twain = 马克·吐温
Edgar Allan Poe = 埃德加·爱伦·坡
Herman Melville = 赫尔曼·梅尔维尔
James Russell Lowell = 詹姆士·拉塞尔·洛威尔
Dr. T. J. Eckleburg = T·J·艾克堡博士

// 死屋之鼠
Fyodor·D = 费奥多尔·D
Ivan Goncharov = 伊凡·冈察洛夫
Aleksandr Pushkin = 亞历山大·普希金
Oguri Mushitarou = 小栗 虫太郎

// 天人五衰
Fyodor·D = 费奥多尔·D
Nikolai Gogol = 尼古拉·果戈里
Sigma = 西格玛
Bram Stoker = 布拉姆·斯托克
Kamui = 神威

// 军警猎犬
Hunting Dogs = 猎犬
Fukuchi Ouchi = 福地 樱痴
Okura Teruko = 大仓 烨子
Jouno Saigiku = 条野 採菊
Suehiro Tetchou = 末广 铁肠
Tachihara Michizou = 立原 道造

// 钟塔侍从
Agatha Christie = 阿加莎·克里斯蒂
Agatha.C = 阿加莎·C

// 其他角色
Oda Sakunosuke = 织田 作之助
Gide = 纪德
Rimbaud Arthur = 阿尔蒂·兰波
Yokomizo Tatsuhiko = 横沟 正史
Sasaki Nobuko = 佐佐木 信子
Bram Stoker = 布拉姆·斯托克
Shirase Buichiro = 白濑 抚一郎
Yua = 柚杏
Natsume Souseki = 夏目 漱石
Katsura Shousaku = 桂 正作
Kouda Aya = 幸田 文
Taguchi Rokuzou = 田口 六藏
Sasaki Nobuko = 佐佐木 信子
Ueda Akinari = 上田 秋成
H. G. Wells = H·G·威尔斯

// 剧场版与小说角色
Shibusawa Tatsuhiko = 涩泽 龙彦
Ayatsuji Yukito = 绫辻 行人
Kyougoku Natsuhiko = 京极 夏彦
Shelley = 雪莱
Adam = 亚当

通用词条

// 地名
Yokohama = 横滨
Yokohama Port = 横滨港
Minato Mirai = 港未来
Chinatown = 中华街
Yamate = 山手
Yokohama Station = 横滨站
Motomachi = 元町
Red Brick Warehouse = 红砖仓库
Yokohama Marine Tower = 横滨海洋塔
Yamashita Park = 山下公园
Harbor View Park = 港见丘公园
Sakuragicho = 樱木町
Kannai = 关内
Isezakicho = 伊势佐木町
Yokohama Bay Bridge = 横滨湾大桥
Yokohama Landmark Tower = 横滨地标塔
Rokkakubashi = 六角桥
Lupin Bar = Lupin 酒吧
Orphanage = 孤儿院
Port Mafia Headquarters = 港口黑手党总部
Armed Detective Agency Office = 武装侦探社事务所
Special Ability Department Office = 异能特务科办公室
Yokohama Prison = 横滨监狱
Train Station = 车站
Warehouse District = 仓库区
Cemetery = 墓地
Abandoned Factory = 废弃工厂
Underground Passage = 地下通道

//名词
Ability = 异能
Ability User = 异能者
Ability Suppression = 异能抑制
Ability Weapon = 异能武器
Orphanage = 孤儿院
Detective = 侦探
Boss = 首领
Subordinate = 部下
Underling = 手下
Executive = 干部
Headquarters = 总部
Mission = 任务
Case File = 案件档案
Secret Base = 秘密基地


// 禁翻词条区
Q
Lupin